######################################
#       # ###      ##    ###  #      #
# ### # #     ### #### #  ##  # ###  #
#   # # # ##### #       #  ## # # #  #
# ### #   ##    #######  # #  # # #  #
#   # # # #  ## #      # # #    # #  #
# ### # # # #   # #### # # # ## # #  #
#   # # # # # ###    # # # #         #
# # # # ### # # #### # # #   #########
#   # #   # # #   ^  # # # # #       #
# # # ## ## # ## ##### # # #   ##### #
#   #     # #    #   # # # #####     #
# #########  ##### # ##  #       #####
#         ##       #    ## ###########
######### ################ #       ###
#         #            #     ####### #
# ######### ###### # # # #####       #
#   #   #   #      # # ### # # #######
# #   #   # # #### # #               #
######################################
